 --- --- --- --- --- --- --- --- --- 
|                                   |
     --- --- --- ---                 
|                   |               |
                 ---                 
|               |   |               |
                                     
|               |   |               |
                                     
|                   |             ^ |
 --- --- --- --- --- --- --- --- --- 