 --- --- --- --- --- --- --- --- --- 
|                                   |
         ---         ---             
|       |   |       |   |           |
     ---         ---                 
|   |       |   |       |           |
     ---         ---                 
|       |   |       |   |           |
                                     
|                                   |
 --- --- --- --- --- --- --- --- --- 